1111111111
1X00E000X1
1CCCCCCCC1
1000000001
1000000001
100000E001
1000000001
1CCCCCCCC1
1X000E0PX1
1111111111
